***************
*   *         *
* **** *** ** *
*       *   * *
* * ** * * G  *
* *      *    *
********S******